S * * * * * * * * * * * W E * 
W W * W W * W W * W W * W W * 
W W * W W * * W * W W * * * * 
W W * W W W W W * W W W * W W 
W W * W W * * * * W W W * W * 
W W * W W * W W W W W W * W * 
W W * W W * W W W W W W * W * 
W * * W W * * * * W W W * * * 
W * W W W W W W * W W W W W W 
W * W W W * * W * W W W W W W 
W * W W W * W W * W W W W W W 
W * W W W * * * * W W W W W W 
W * W W W W W W W W W W W W W 
W * W W W W W W W W W W W W W 
* * W W W W W W W W W W W W W 
